B0WWW000000000W0
00W000000000W000
00W0WWWWWW00W000
00Y0S00S0000S002
00W0W00WWWWWWS00
00W0W0000000W000
00W0W0000000W000
0000W0000000W000
0W00W0W000W0W000
0W0000W000W00000
000000W0WWWW0000
WWW000W000WWWW00
000000W0000WO00W
W000W00W000W0000
WO00W00W00000040
WWWWWWWW00000000