0000000000000000
0000000000000000
000000W0000000W0
0000000W00000000
0000000000W00000
0000000000000W00
0000000Y0000W00W
00W0000000000000
0W00000000000000
00000000000000W0
000000W000000000
00000000W0000000
000W000000000000
00000W0000000000
W000000000000W00
B00000W000000000